Walk forward, and turn (towards 10 o'clock) and continue walking , then turn (towards 10 o'clock) and continue walking .
Walk forward, and turn right and continue walking , and turn right and continue walking .
Trapezoid: using a trajectory that forms a trapezoid with one pair of parallel sides.
Spiral: using a trajectory that starts at the center and spirals outward.
Heart: using a trajectory that forms the shape of a heart.
Wave: using a trajectory that follows a wavy pattern.
Circle: using a trajectory that forms a complete circle.
Triangle: using a trajectory that forms an equilateral triangle.
Pentagon: using a trajectory that forms a regular pentagon.
Infinity: using a trajectory that forms the shape of an infinity symbol.
Crescent: using a trajectory that forms the shape of a crescent moon.
Lightning: using a trajectory that forms the shape of a lightning bolt.
SnakeTrajectory: using a continuous trajectory that resembles a snake.
Spiral: using a trajectory that forms a spiral starting from the center and moving outward.
Semicircle: using a trajectory that forms a half-circle.
Arrow: using a trajectory that forms an arrow shape with a straight line and a triangular head.
Ellipse: using a trajectory that forms an elongated circle, or oval shape.
Square: using a square trajectory with a return to the origin.
Inverse_N: using a trajectory of an inverse 'N' shape.
3dots: using a trajectory that passes through three specific points not in a straight trajectory.
SDF: using a straight trajectory.
Zigzag: using a zigzag trajectory.
135angleLeft: moving forward and then making a 135-degree turn to the left.
120angleRight: moving forward and then making a 120-degree turn to the right.
110angleRight: moving forward and then making a 110-degree turn to the right.
90angleRight: moving forward and then making a 90-degree turn to the right.
60angleRight: moving forward and then making a 60-degree turn to the right.
30angleLeft: moving forward and then making a 30-degree turn to the left.
30angleRight: moving forwardsemi_cirlcle_avoid_walk ：a man is walking/runing, he tried to avoid one sphere using semi_cirlcle trajectory in the middle. It means that he walks straight 10 m first, then turn using a  semi_cirlcle trajectory(10 m ), than walk straight (10 m )again. and then making a 30-degree turn to the right.
CapitalJ: using a trajectory resembling the capital letter 'J'.
CapitalL: using a trajectory resembling the capital letter 'L'.
CapitalU: using a trajectory resembling the capital letter 'U'.
CapitalV: using a trajectory resembling the capital letter 'V'.
CapitalZ: using a trajectory resembling the capital letter 'Z'.
Number0: using a trajectory resembling the number '0'.
Number1: using a trajectory resembling the number '1'.
Number7: using a trajectory resembling the number '7'.
Number8: using a trajectory resembling the number '8'.
Number6: using a trajectory resembling the number '6'.
Number9: using a trajectory resembling the number '9'.
CapitalGamma: using a trajectory resembling the capital Greek letter 'Γ' (Gamma).
CapitalLambda: using a trajectory resembling the capital Greek letter 'Λ' (Lambda).
CapitalPi: using a trajectory resembling the capital Greek letter 'Π' (Pi).
CapitalSigma: using a trajectory resembling the capital Greek letter 'Σ' (Sigma).
CapitalUpsilon: using a trajectory resembling the capital Greek letter 'Υ' (Upsilon).
LowercaseUpsilon: using a trajectory resembling the lowercase Greek letter 'υ' (upsilon).